#################
#R..#...........L
#...#*.#........#
#......#.......\#
#################