#######
#..***#
#..///#
# ..**#
#.*.*/#
LR....#
#######